BCH	BitcoinCash
BLK	BlackCoin
BTC	Bitcoin
BTG	Bitcoin Gold
RYO	c0ban
CITY	CityCoin
DASH	Dash
DNR	Denarius
DCR	Decred
DGB	DigiByte
DOGE	Dogecoin
GRS	Groestlcoin
LTC	Litecoin
VIA	Viacoin
MONA	Monacoin
NBT	NuBits
NMC	Namecoin
PPC	Peercoin
QTUM	Qtum
RVN	Ravencoin
RDD	ReddCoin
VTC	Vertcoin
x42	x42
ZEC	Zcash
